B..#############
#........#..#..#
#..#######..#..#
#.....#........#
#..#######..####
#..............#
####..#######..#
#.....#........#
#..####..#..#..#
#..#.....#..#.A#
################